c,c,d,d,e
0,0,b,0,e
a,a,b,0,r
0,0,0,0,r
0,h,h,0,0
