b,c,0,d,d,d
b,c,0,e,f,g
a,a,0,e,f,g
0,0,0,h,h,h
i,i,0,0,0,0
0,0,0,j,j,0
