0,0,0,0,0,0
0,0,0,0,0,0
0,a,a,e,0,0
0,b,b,e,0,f
0,c,0,e,0,f
0,c,d,d,0,f
