c,c,d,d,0,k
b,b,b,0,j,k
a,a,g,i,j,k
0,f,g,i,0,0
0,f,h,i,0,0
0,f,h,0,0,0