b,0,0,c,0,0
b,0,0,c,0,0
b,a,a,c,0,0
0,0,d,e,e,e
0,0,d,0,0,g
0,0,f,f,f,g