0,c,c,0,i,0
0,b,b,b,i,j
a,a,f,g,0,j
0,d,f,g,0,0
0,d,h,0,0,0
e,e,h,0,0,0