0,b,i,i,j,j
0,b,e,f,g,h
a,a,e,f,g,h
c,d,k,k,k,0
c,d,0,0,0,0
0,0,0,0,0,0