b,h,h,i,0,0
b,0,g,i,k,k
a,a,g,j,0,l
c,c,c,j,0,l
d,e,f,0,0,0
d,e,f,0,0,0